1111111111111
1P00000000001
10CCCCCCCCC01
10000000000E1
1111111111111
