1111111111111
10010000000C1
0000011111000
1P0011E000001
1111111111111
