1111111111111111111111111111111111111111
1P0000000C000001000111110CCC111111111111
11111101111111010100F0000CEC111111111111
1C000000C0000100010111110CCC111111111111
10111111110101111100000111111F1111111111
101111C111010100C111110C0000111101111111
1000C10000010101110001111110111101111111
111111111111C1000001000C0000111110111111
1000000001C11111111110111101111100111111
101110110100001C111000000000111111F11111
1000100101111010111010101C1C111111111111
1110110101000010000010101111111111111111
1C00CF0100011111111110101C00111111111111
1111110111011000100010101110111111111111
1E000001C0000010001000100000111111111111
1111111111111111111111111111111111111111
1111111111111111111111111111111111111111
1111111111111111111111111111111111111111
1111111111111111111111111111111111111111
1111111111111111111111111111111111111111
