1111111111111111111111
1P000000000000000000C1
10000000C000C000101001
111110000C0001110000E1
1FFFF00000000000CE0001
1111111111111111111111
