11111111111111111111
1100000000000P000001
1F000011110000111001
100C0001110010111001
100C0101100110011001
1CCCCCCCCCCCCCCCCCC1
10C010C1010C01C10C11
1E000000000000000001
11111111111111111111