1111111111111111111111
1P00001000100000000001
1001000010000000000001
1111111111100000000001
1000000000000000000001
10000111011110001000E1
100C010F00001000100111
100001C00F001000100001
1000011100111000111001
1000000000000000000E01
1111111111111111111111
